1111111111111111111111111111111111
1P1CCCFCCCFCCCFCCCFCCCFCCCFCCCFFE1
101CCCFCCCFCCCFCCCFCCCFCCCFCCCFCC1
1CCC1CCCFCCCFCCCFCCCFCCCFCCCFCCCF1
1CCC1CCCFCCCFCCCFCCCFCCCFCCCFCCCF1
1111111111111111111111111111111111
