111111111111111111111
1P0000000000C000000C1
1E0111111101111111101
111111110000111111011
1101C00001F00C0000011
110101111001000100011
11010F000011000101111
11010F011111000100011
11011001000111110C011
11010001011100000F111
110101010001011111111
110100010C01000001011
110100011101111101011
11010100000100C001011
110101011101000101011
110101000001001100011
11010100C00101111C011
110100000001000010011
110100000101010110111
110100C00101010110111
1101111C1111110110111
110110001111110110111
11000011111000C000011
11000C000000000100011
111111111101111111111
1100000C0C00000100011
110111111111100100011
110111111111100000011
111111111111111111111
